C 0,120,00000000000000010






NO north






SO south
F 254,255,255






WE west



EA east






        111111111111111111111111
        1000000000110000000000001
        1011000001110000000000001
        1001N00000000000000000001
111111111011000001110000000000001
10000000001100000111011111110111
11110111111111011100000010001    
11110111111111011101010010001
11000000110101011100000010001
10000000000000001100000010001
10000000000000001101010010001
1100000111010101111101111000111
11110111 1110101 101111010001
11111111 1111111 111111111111





