C 0,120,00000000000000010






NO north






SO south
F 254,255,255






WE west



EA east






11111111111111111111111111111111
10000000000000000110000000000001
100000000110000011100000N0000001
11111111100100000000000000000001
11111111011000001110000000000001
10000000001100000111011111010111
11110111111111011100000010001    
11110111111111011101010010001
11000000110101011100000010001
10000000000000001100000010001
10000000000000000001010010001
1100000111010101110101101000111
11110111 1110101 101111010001
11111111 1111111 111111111111





