C 0,120,00000000000000010
NO north
SO south
F 254,255,255
WE west
EA east

11111111111111111111111
1N0000000000000000000001
100000000000000000000001
100000000000000000000001
110000000000000000000001
111011111000000000000001
100000010001000000000001   
101010010000000000000001
111111111111111111111111
