C 0,120,00000000000000010
NO north
SO south
F 254,255,255
WE west
EA east

111111111111111
1S1100000000001
100000000000001
100000000000001
110000000000001
111011111010111
100000010001    
101010010001
11111111111111
